"#SampleID"	"__f_primer"	"__r_primer"
"#q2:types"	"categorical"	"categorical"
"Mock1-BITS"	"CTACCTGCGGARGGATCA"	"GAGATCCRTTGYTRAAAGTT"
"Mock1-ITSnew"	"CTTGGTCATTTAGAGGAAGTAA"	"GCTGCGTTCTTCATCGATGC"
"Mock2-BITS"	"CTACCTGCGGARGGATCA"	"GAGATCCRTTGYTRAAAGTT"
"Mock2-ITSnew"	"CTTGGTCATTTAGAGGAAGTAA"	"GCTGCGTTCTTCATCGATGC"
"Mock3-BITS"	"CTACCTGCGGARGGATCA"	"GAGATCCRTTGYTRAAAGTT"
"Mock3-ITSnew"	"CTTGGTCATTTAGAGGAAGTAA"	"GCTGCGTTCTTCATCGATGC"
"Mock4-BITS"	"CTACCTGCGGARGGATCA"	"GAGATCCRTTGYTRAAAGTT"
"Mock4-ITSnew"	"CTTGGTCATTTAGAGGAAGTAA"	"GCTGCGTTCTTCATCGATGC"
"Mock5-ITSnew"	"CTTGGTCATTTAGAGGAAGTAA"	"GCTGCGTTCTTCATCGATGC"
"Sludge-1-BITS"	"CTACCTGCGGARGGATCA"	"GAGATCCRTTGYTRAAAGTT"
"Sludge-1-ITSnew"	"CTTGGTCATTTAGAGGAAGTAA"	"GCTGCGTTCTTCATCGATGC"
"Sludge-2-BITS"	"CTACCTGCGGARGGATCA"	"GAGATCCRTTGYTRAAAGTT"
"Sludge-2-ITSnew"	"CTTGGTCATTTAGAGGAAGTAA"	"GCTGCGTTCTTCATCGATGC"
"Sludge-3-BITS"	"CTACCTGCGGARGGATCA"	"GAGATCCRTTGYTRAAAGTT"
"Sludge-3-ITSnew"	"CTTGGTCATTTAGAGGAAGTAA"	"GCTGCGTTCTTCATCGATGC"
"Sludge-4-BITS"	"CTACCTGCGGARGGATCA"	"GAGATCCRTTGYTRAAAGTT"
"Sludge-4-ITSnew"	"CTTGGTCATTTAGAGGAAGTAA"	"GCTGCGTTCTTCATCGATGC"
"Sponge-1-BITS"	"CTACCTGCGGARGGATCA"	"GAGATCCRTTGYTRAAAGTT"
"Sponge-1-ITSnew"	"CTTGGTCATTTAGAGGAAGTAA"	"GCTGCGTTCTTCATCGATGC"
"Sponge-3-BITS"	"CTACCTGCGGARGGATCA"	"GAGATCCRTTGYTRAAAGTT"
"Sponge-3-ITSnew"	"CTTGGTCATTTAGAGGAAGTAA"	"GCTGCGTTCTTCATCGATGC"
"Sponge-5-BITS"	"CTACCTGCGGARGGATCA"	"GAGATCCRTTGYTRAAAGTT"
"Sponge-5-ITSnew"	"CTTGGTCATTTAGAGGAAGTAA"	"GCTGCGTTCTTCATCGATGC"
"Sponge-7-BITS"	"CTACCTGCGGARGGATCA"	"GAGATCCRTTGYTRAAAGTT"
"Sponge-7-ITSnew"	"CTTGGTCATTTAGAGGAAGTAA"	"GCTGCGTTCTTCATCGATGC"
"Water-1-BITS"	"CTACCTGCGGARGGATCA"	"GAGATCCRTTGYTRAAAGTT"
"Water-1-ITSnew"	"CTTGGTCATTTAGAGGAAGTAA"	"GCTGCGTTCTTCATCGATGC"
"Water-2-BITS"	"CTACCTGCGGARGGATCA"	"GAGATCCRTTGYTRAAAGTT"
"Water-2-ITSnew"	"CTTGGTCATTTAGAGGAAGTAA"	"GCTGCGTTCTTCATCGATGC"
"Water-3-BITS"	"CTACCTGCGGARGGATCA"	"GAGATCCRTTGYTRAAAGTT"
"Water-3-ITSnew"	"CTTGGTCATTTAGAGGAAGTAA"	"GCTGCGTTCTTCATCGATGC"
"Water-4-BITS"	"CTACCTGCGGARGGATCA"	"GAGATCCRTTGYTRAAAGTT"
"Water-4-ITSnew"	"CTTGGTCATTTAGAGGAAGTAA"	"GCTGCGTTCTTCATCGATGC"
